0 0 0 0 0 0 0
0 1 1 2 3 1 0
0 2 0 4 5 1 0
0 1 2 0 6 0 0
0 3 2 0 3 2 0
0 2 1 3 1 4 0
0 0 0 0 0 0 0
